{
	"tilesetImageFile":"/images/bricks.png",
	"tileSize":32,
	"tileLayer":[
        [49,49, 0, 0, 0, 0, 0, 0, 0, 0, 0, 0, 0, 0, 0, 0, 0, 0, 0, 0, 0, 0, 0, 0, 0, 0, 0, 0, 0, 0, 0, 0, 0, 0, 0, 0, 0, 0, 0, 0, 0, 0, 0, 0, 0, 0, 0, 0, 0, 0, 0, 0, 0, 0, 0, 0, 0, 0, 0, 0, 0, 0, 0, 0, 0, 0, 0, 0, 0, 0, 0, 0, 0, 0, 0, 0, 0, 0, 0, 0, 0, 0, 0, 0, 0, 0, 0, 0, 0, 0, 0, 0, 0, 0, 0, 0, 0, 0, 0, 0, 0, 0, 0, 0, 0, 0, 0, 0, 0, 0, 0, 0, 0, 0, 0, 0, 0, 0,49,49],
		[49, 0, 0, 0, 0, 0, 0, 0, 0, 0, 0, 0, 0, 0, 0, 0, 0, 0, 0, 0, 0, 0, 0, 0, 0, 0, 0, 0, 0, 0, 0, 0, 0, 0, 0, 0, 0, 0, 0, 0, 0, 0, 0, 0, 0, 0, 0, 0, 0, 0, 0, 0, 0, 0, 0, 0, 0, 0, 0, 0, 0, 0, 0, 0, 0, 0, 0, 0, 0, 0, 0, 0, 0, 0, 0, 0, 0, 0, 0, 0, 0, 0, 0, 0, 0, 0, 0, 0, 0, 0, 0, 0, 0, 0, 0, 0, 0, 0, 0, 0, 0, 0, 0, 0, 0, 0, 0, 0, 0, 0, 0, 0, 0, 0, 0, 0, 0, 0, 0,49],
        [ 0, 0,49,49, 0, 0,49,49, 0, 0,49,49, 0, 0,49,49, 0, 0,49,49, 0, 0,49,49, 0, 0,49,49, 0, 0,49,49, 0, 0,49,49, 0, 0,49,49, 0, 0,49,49, 0, 0,49,49, 0, 0,49,49, 0, 0,49,49, 0, 0,49,49, 0, 0,49,49, 0, 0,49,49, 0, 0,49,49, 0, 0,49,49, 0, 0,49,49, 0, 0,49,49, 0, 0,49,49, 0, 0,49,49, 0, 0,49,49, 0, 0,49,49, 0, 0,49,49, 0, 0,49,49, 0, 0, 0, 0,49,49, 0, 0,49,49, 0, 0],
        [ 0, 0,49,49, 0, 0,49,49, 0, 0,49,49, 0, 0,49,49, 0, 0,49,49, 0, 0,49,49, 0, 0,49,49, 0, 0,49,49, 0, 0,49,49, 0, 0,49,49, 0, 0,49,49, 0, 0,49,49, 0, 0,49,49, 0, 0,49,49, 0, 0,49,49, 0, 0,49,49, 0, 0,49,49, 0, 0,49,49, 0, 0,49,49, 0, 0,49,49, 0, 0,49,49, 0, 0,49,49, 0, 0,49,49, 0, 0,49,49, 0, 0,49,49, 0, 0,49,49, 0, 0,49,49, 0, 0, 0, 0,49,49, 0, 0,49,49, 0, 0],
        [ 0, 0, 0, 0, 0, 0, 0, 0, 0, 0, 0, 0, 0, 0, 0, 0, 0, 0, 0, 0, 0, 0, 0, 0, 0, 0, 0, 0, 0, 0, 0, 0, 0, 0, 0, 0, 0, 0, 0, 0, 0, 0, 0, 0, 0, 0, 0, 0, 0, 0, 0, 0, 0, 0, 0, 0, 0, 0, 0, 0, 0, 0, 0, 0, 0, 0, 0, 0, 0, 0, 0, 0, 0, 0, 0, 0, 0, 0, 0, 0, 0, 0, 0, 0, 0, 0, 0, 0, 0, 0, 0, 0, 0, 0, 0, 0, 0, 0, 0, 0, 0, 0, 0, 0, 0, 0, 0, 0, 0, 0, 0, 0, 0, 0, 0, 0, 0, 0, 0, 0],
		[ 0, 0, 0, 0, 0, 0, 0, 0, 0, 0, 0, 0, 0, 0, 0, 0, 0, 0, 0, 0, 0, 0, 0, 0, 0, 0, 0, 0, 0, 0, 0, 0, 0, 0, 0, 0, 0, 0, 0, 0, 0, 0, 0, 0, 0, 0, 0, 0, 0, 0, 0, 0, 0, 0, 0, 0, 0, 0, 0, 0, 0, 0, 0, 0, 0, 0, 0, 0, 0, 0, 0, 0, 0, 0, 0, 0, 0, 0, 0, 0, 0, 0, 0, 0, 0, 0, 0, 0, 0, 0, 0, 0, 0, 0, 0, 0, 0, 0, 0, 0, 0, 0, 0, 0, 0, 0, 0, 0, 0, 0, 0, 0, 0, 0, 0, 0, 0, 0, 0, 0],
        [ 0, 0,49,49, 0, 0,49,49, 0, 0,49,49, 0, 0,49,49, 0, 0,49,49, 0, 0,49,49, 0, 0,49,49, 0, 0,49,49, 0, 0,49,49, 0, 0,49,49, 0, 0,49,49, 0, 0,49,49, 0, 0,49,49, 0, 0,49,49, 0, 0,49,49, 0, 0,49,49, 0, 0,49,49, 0, 0,49,49, 0, 0,49,49, 0, 0,49,49, 0, 0,49,49, 0, 0,49,49, 0, 0,49,49, 0, 0,49,49, 0, 0,49,49, 0, 0,49,49, 0, 0,49,49, 0, 0, 0, 0,49,49, 0, 0,49,49, 0, 0],
        [ 0, 0,49,49, 0, 0,49,49, 0, 0,49,49, 0, 0,49,49, 0, 0,49,49, 0, 0,49,49, 0, 0,49,49, 0, 0,49,49, 0, 0,49,49, 0, 0,49,49, 0, 0,49,49, 0, 0,49,49, 0, 0,49,49, 0, 0,49,49, 0, 0,49,49, 0, 0,49,49, 0, 0,49,49, 0, 0,49,49, 0, 0,49,49, 0, 0,49,49, 0, 0,49,49, 0, 0,49,49, 0, 0,49,49, 0, 0,49,49, 0, 0,49,49, 0, 0,49,49, 0, 0,49,49, 0, 0, 0, 0,49,49, 0, 0,49,49, 0, 0],
        [ 0, 0, 0, 0, 0, 0, 0, 0, 0, 0, 0, 0, 0, 0, 0, 0, 0, 0, 0, 0, 0, 0, 0, 0, 0, 0, 0, 0, 0, 0, 0, 0, 0, 0, 0, 0, 0, 0, 0, 0, 0, 0, 0, 0, 0, 0, 0, 0, 0, 0, 0, 0, 0, 0, 0, 0, 0, 0, 0, 0, 0, 0, 0, 0, 0, 0, 0, 0, 0, 0, 0, 0, 0, 0, 0, 0, 0, 0, 0, 0, 0, 0, 0, 0, 0, 0, 0, 0, 0, 0, 0, 0, 0, 0, 0, 0, 0, 0, 0, 0, 0, 0, 0, 0, 0, 0, 0, 0, 0, 0, 0, 0, 0, 0, 0, 0, 0, 0, 0, 0],
		[ 0, 0, 0, 0, 0, 0, 0, 0, 0, 0, 0, 0, 0, 0, 0, 0, 0, 0, 0, 0, 0, 0, 0, 0, 0, 0, 0, 0, 0, 0, 0, 0, 0, 0, 0, 0, 0, 0, 0, 0, 0, 0, 0, 0, 0, 0, 0, 0, 0, 0, 0, 0, 0, 0, 0, 0, 0, 0, 0, 0, 0, 0, 0, 0, 0, 0, 0, 0, 0, 0, 0, 0, 0, 0, 0, 0, 0, 0, 0, 0, 0, 0, 0, 0, 0, 0, 0, 0, 0, 0, 0, 0, 0, 0, 0, 0, 0, 0, 0, 0, 0, 0, 0, 0, 0, 0, 0, 0, 0, 0, 0, 0, 0, 0, 0, 0, 0, 0, 0, 0],
        [ 0, 0,49,49, 0, 0,49,49, 0, 0,49,49, 0, 0,49,49, 0, 0,49,49, 0, 0,49,49, 0, 0,49,49, 0, 0,49,49, 0, 0,49,49, 0, 0,49,49, 0, 0,49,49, 0, 0,49,49, 0, 0,49,49, 0, 0,49,49, 0, 0,49,49, 0, 0,49,49, 0, 0,49,49, 0, 0,49,49, 0, 0,49,49, 0, 0,49,49, 0, 0,49,49, 0, 0,49,49, 0, 0,49,49, 0, 0,49,49, 0, 0,49,49, 0, 0,49,49, 0, 0,49,49, 0, 0, 0, 0,49,49, 0, 0,49,49, 0, 0],
        [ 0, 0,49,49, 0, 0,49,49, 0, 0,49,49, 0, 0,49,49, 0, 0,49,49, 0, 0,49,49, 0, 0,49,49, 0, 0,49,49, 0, 0,49,49, 0, 0,49,49, 0, 0,49,49, 0, 0,49,49, 0, 0,49,49, 0, 0,49,49, 0, 0,49,49, 0, 0,49,49, 0, 0,49,49, 0, 0,49,49, 0, 0,49,49, 0, 0,49,49, 0, 0,49,49, 0, 0,49,49, 0, 0,49,49, 0, 0,49,49, 0, 0,49,49, 0, 0,49,49, 0, 0,49,49, 0, 0, 0, 0,49,49, 0, 0,49,49, 0, 0],
		[ 0, 0, 0, 0, 0, 0, 0, 0, 0, 0, 0, 0, 0, 0, 0, 0, 0, 0, 0, 0, 0, 0, 0, 0, 0, 0, 0, 0, 0, 0, 0, 0, 0, 0, 0, 0, 0, 0, 0, 0, 0, 0, 0, 0, 0, 0, 0, 0, 0, 0, 0, 0, 0, 0, 0, 0, 0, 0, 0, 0, 0, 0, 0, 0, 0, 0, 0, 0, 0, 0, 0, 0, 0, 0, 0, 0, 0, 0, 0, 0, 0, 0, 0, 0, 0, 0, 0, 0, 0, 0, 0, 0, 0, 0, 0, 0, 0, 0, 0, 0, 0, 0, 0, 0, 0, 0, 0, 0, 0, 0, 0, 0, 0, 0, 0, 0, 0, 0, 0, 0],
		[ 0, 0, 0, 0, 0, 0, 0, 0, 0, 0, 0, 0, 0, 0, 0, 0, 0, 0, 0, 0, 0, 0, 0, 0, 0, 0, 0, 0, 0, 0, 0, 0, 0, 0, 0, 0, 0, 0, 0, 0, 0, 0, 0, 0, 0, 0, 0, 0, 0, 0, 0, 0, 0, 0, 0, 0, 0, 0, 0, 0, 0, 0, 0, 0, 0, 0, 0, 0, 0, 0, 0, 0, 0, 0, 0, 0, 0, 0, 0, 0, 0, 0, 0, 0, 0, 0, 0, 0, 0, 0, 0, 0, 0, 0, 0, 0, 0, 0, 0, 0, 0, 0, 0, 0, 0, 0, 0, 0, 0, 0, 0, 0, 0, 0, 0, 0, 0, 0, 0, 0],
		[ 0, 0, 0, 0, 0, 0, 0, 0, 0, 0, 0, 0, 0, 0, 0, 0, 0, 0, 0, 0, 0, 0, 0, 0, 0, 0, 0, 0, 0, 0, 0, 0, 0, 0, 0, 0, 0, 0, 0, 0, 0, 0, 0, 0, 0, 0, 0, 0, 0, 0, 0, 0, 0, 0, 0, 0, 0, 0, 0, 0, 0, 0, 0, 0, 0, 0, 0, 0, 0, 0, 0, 0, 0, 0, 0, 0, 0, 0, 0, 0, 0, 0, 0, 0, 0, 0, 0, 0, 0, 0, 0, 0, 0, 0, 0, 0, 0, 0, 0, 0, 0, 0, 0, 0, 0, 0, 0, 0, 0, 0, 0, 0, 0, 0, 0, 0, 0, 0, 0, 0],
		[ 0, 0, 0, 0, 0, 0, 0, 0, 0, 0, 0, 0, 0, 0, 0, 0, 0, 0, 0, 0, 0, 0, 0, 0, 0, 0, 0, 0, 0, 0, 0, 0, 0, 0, 0, 0, 0, 0, 0, 0, 0, 0, 0, 0, 0, 0, 0, 0, 0, 0, 0, 0, 0, 0, 0, 0, 0, 0, 0, 0, 0, 0, 0, 0, 0, 0, 0, 0, 0, 0, 0, 0, 0, 0, 0, 0, 0, 0, 0, 0, 0, 0, 0, 0, 0, 0, 0, 0, 0, 0, 0, 0, 0, 0, 0, 0, 0, 0, 0, 0, 0, 0, 0, 0, 0, 0, 0, 0, 0, 0, 0, 0, 0, 0, 0, 0, 0, 0, 0, 0],
		[ 0, 0, 0, 0, 0, 0,49,49,49, 0, 0,34,34,34,34, 0, 0,49,49,49, 0, 0, 0, 0, 0, 0, 0, 0, 0, 0, 0, 0, 0, 0, 0, 0, 0, 0, 0, 0, 0, 0, 0, 0, 0, 0, 0, 0, 0, 0, 0, 0, 0, 0, 0, 0, 0, 0, 0, 0, 0, 0, 0, 0, 0, 0, 0, 0, 0, 0, 0, 0, 0, 0, 0, 0, 0, 0, 0, 0, 0, 0, 0, 0, 0, 0, 0, 0, 0, 0, 0, 0, 0, 0, 0, 0, 0, 0, 0, 0, 0, 0, 0, 0, 0, 0, 0, 0, 0, 0, 0, 0, 0, 0, 0, 0, 0, 0, 0, 0],
		[ 0, 0, 0, 0, 0, 0, 0, 0, 0, 0, 0,34,42,42,34, 0, 0, 0, 0, 0, 0, 0, 0, 0, 0, 0, 0, 0, 0, 0, 0, 0, 0, 0, 0, 0, 0, 0, 0, 0, 0, 0, 0, 0, 0, 0, 0, 0, 0, 0, 0, 0, 0, 0, 0, 0, 0, 0, 0, 0, 0, 0, 0, 0, 0, 0, 0, 0, 0, 0, 0, 0, 0, 0, 0, 0, 0, 0, 0, 0, 0, 0, 0, 0, 0, 0, 0, 0, 0, 0, 0, 0, 0, 0, 0, 0, 0, 0, 0, 0, 0, 0, 0, 0, 0, 0, 0, 0, 0, 0, 0, 0, 0, 0, 0, 0, 0, 0, 0, 0],
		[ 0, 0, 0, 0, 0, 0, 0, 0, 0, 0,34,42,42,42,42,34, 0, 0, 0, 0, 0, 0, 0, 0, 0, 0, 0, 0, 0, 0, 0, 0, 0, 0, 0, 0, 0, 0, 0, 0, 0, 0, 0, 0, 0, 0, 0, 0, 0, 0, 0, 0, 0, 0, 0, 0, 0, 0, 0, 0, 0, 0, 0, 0, 0, 0, 0, 0, 0, 0, 0, 0, 0, 0, 0, 0, 0, 0, 0, 0, 0, 0, 0, 0, 0, 0, 0, 0, 0, 0, 0, 0, 0, 0, 0, 0, 0, 0, 0, 0, 0, 0, 0, 0, 0, 0, 0, 0, 0, 0, 0, 0, 0, 0, 0, 0, 0, 0, 0, 0],
		[42,42,42,42,42,42,42,42,42,42,42,42,42,42,42,42,42,42,42,42,42,42,42,42,42,42,42,42,42,42,42,42,42,42,42,42,42,42,42,42,42,42,42,42,42,42,42,42,42,42,42,42,42,42,42,42,42,42,42,42,42,42,42,42,42,42,42,42,42,42,42,42,42,42,42,42,42,42,42,42,42,42,42,42,42,42,42,42,42,42,42,42,42,42,42,42,42,42,42,42,42,42,42,42,42,42,42,42,42,42,42,42,42,42,42,42,42,42,42,50]
	],
	"objectLayer":[
		{
            "name":"player",
			"shape":[32, 32, 32, 32]
		},
        {
            "name":"enemy",
			"shape":[32, 384, 32, 32]
		},
        {
            "name":"enemy",
			"shape":[96, 384, 32, 32]
		},
        {
            "name":"enemy",
			"shape":[160, 384, 32, 32]
		}
	]
}
